###############
#             #
##### ###### ##
###   ######  S
#####E#########